################
# ###          #
# ##  #  ####  #
#     ######   #
###    ## ## #F#
# #  # ##  #####
#   ##         #
# #     #####  #
# ####    # #  #
#  # ###    ## #
#    ##  ## #  #
##    ## #  # ##
#  ##   ######S#
# #   #        #
################